********************************
********************************
********************************
********************************
********************************
********************************
********************************
********************************
********************************
********************************
********************************
********************************
********************************
********************************
********************************
********************************
********************************
********************************
***BBBBBBBB*********************
********************************
********************************
********************************
88888888888888888888888888888888
88888888888888888888888888888888